NONE|No Contest ID
RSGB-160|1.8MHz Contest
RSGB-21/28-CW|21/28 MHz Contest (CW)
RSGB-21/28-SSB|21/28 MHz Contest (SSB)
7QP|7th-Area QSO Party
RSGB-80M-CC|80m Club Championships
RSGB-AFS-CW|Affiliated Societies Team Contest (CW)
RSGB-AFS-SSB|Affiliated Societies Team Contest (SSB)
AL-QSO-PARTY|Alabama QSO Party
VOLTA-RTTY|Alessandro Volta RTTY DX Contest
ANARTS-RTTY|ANARTS WW RTTY
ANATOLIAN-RTTY|Anatolian WW RTTY
ARI-DX|ARI DX Contest
AZ-QSO-PARTY|Arizona QSO Party
AR-QSO-PARTY|Arkansas QSO Party
ARRL-10-GHZ|ARRL 10 GHz and Up Contest
ARRL-10|ARRL 10 Meter Contest
ARRL-160|ARRL 160 Meter Contest
ARRL-222|ARRL 222 MHz and Up Distance Contest
ARRL-UHF-AUG|ARRL August UHF Contest
ARRL-EME|ARRL EME contest
ARRL-FIELD-DAY|ARRL Field Day
ARRL-DX-CW|ARRL International DX Contest (CW)
ARRL-DX-SSB|ARRL International DX Contest (Phone)
ARRL-VHF-JAN|ARRL January VHF Sweepstakes
ARRL-VHF-JUN|ARRL June VHF QSO Party
ARRL-SS-CW|ARRL November Sweepstakes (CW)
ARRL-SS-SSB|ARRL November Sweepstakes (Phone)
ARRL-RR-CW|ARRL Rookie Roundup (CW)
ARRL-RR-SSB|ARRL Rookie Roundup (Phone)
ARRL-RR-RTTY|ARRL Rookie Roundup (RTTY)
ARRL-RTTY|ARRL RTTY Round-Up
ARRL-SCR|ARRL School Club Roundup
ARRL-VHF-SEP|ARRL September VHF QSO Party
AP-SPRINT|Asia - Pacific Sprint
EA-VHF-ATLANTIC|Atlantico V-UHF
BARTG-RTTY|BARTG Spring RTTY Contest
BARTG-SPRINT|BARTG Sprint Contest
BC-QSO-PARTY|British Columbia QSO Party
CA-QSO-PARTY|California QSO Party
RAC (import-only)|Canadian Amateur Radio Society Contest
CIS-DX|CIS DX Contest
RSGB-CLUB-CALLS|Club Calls
CO-QSO-PARTY|Colorado QSO Party
EA-VHF-COM|Combinado de V-UHF
RSGB-COMMONWEALTH|Commonwealth Contest
EA-CNCW|Concurso Nacional de Telegrafia
CVA-DX-CW|Concurso Verde e Amarelo DX CW Contest
CVA-DX-SSB|Concurso Verde e Amarelo DX CW Contest
CT-QSO-PARTY|Connecticut QSO Party
EA-VHF-COSTA-SOL|Costa del Sol V-UHF
CQ-VHF|CQ World-Wide VHF Contest
CQ-160-CW|CQ WW 160 Meter DX Contest (CW)
CQ-160-SSB|CQ WW 160 Meter DX Contest (SSB)
CQ-WW-CW|CQ WW DX Contest (CW)
CQ-WW-SSB|CQ WW DX Contest (SSB)
CQ-WPX-CW|CQ WW WPX Contest (CW)
CQ-WPX-SSB|CQ WW WPX Contest (SSB)
CQ-WW-RTTY|CQ/RJ WW RTTY DX Contest
CQ-WPX-RTTY|CQ/RJ WW RTTY WPX Contest
CQ-M|CQ-M International DX Contest
CWOPS-CW-OPEN|CWops CW Open Competition
CWOPS-CWT|CWops Mini-CWT Test
OK-DX-RTTY|Czech Radio Club OK DX Contest
OK-OM-DX|Czech Radio Club OK-OM DX Contest
IARU-FIELD-DAY|DARC IARU Region 1 Field Day
DARC-WAG|DARC Worked All Germany
DE-QSO-PARTY|Delaware QSO Party
DL-DX-RTTY|DL-DX RTTY Contest
DMC-RTTY|DMC RTTY Contest
LDC-RTTY|DRCG Long Distance Contest (RTTY)
PACC|Dutch PACC Contest
EA-PSK63|EA PSK63
EU-HF|EU HF Championship
EU-PSK-DX|EU PSK DX Contest
EU Sprint|EU Sprint
EUCW160M|European CW Association 160m CW Party
UK-DX-BPSK63|European PSK Club BPSK63 Contest
FALL SPRINT|FISTS Fall Sprint
SPRING SPRINT|FISTS Spring Sprint
SUMMER SPRINT|FISTS Summer Sprint
WINTER SPRINT|FISTS Winter Sprint
FL-QSO-PARTY|Florida QSO Party
GA-QSO-PARTY|Georgia QSO Party
HI-QSO-PARTY|Hawaiian QSO Party
HELVETIA|Helvetia Contest
HA-DX|Hungarian DX Contest
HOLYLAND|IARC Holyland Contest
IARU-HF|IARU HF World Championship
ID-QSO-PARTY|Idaho QSO Party
IL QSO Party|Illinois QSO Party
IN-QSO-PARTY|Indiana QSO Party
RSGB-IOTA|IOTA Contest
IA-QSO-PARTY|Iowa QSO Party
JIDX-CW|Japan International DX Contest (CW)
JIDX-SSB|Japan International DX Contest (SSB)
ALL-ASIAN-DX-CW|JARL All Asian DX Contest (CW)
ALL-ASIAN-DX-PHONE|JARL All Asian DX Contest (PHONE)
JARTS-WW-RTTY|JARTS WW RTTY
K1USN-SST|K1USN Slow Speed Test
KS-QSO-PARTY|Kansas QSO Party
KY-QSO-PARTY|Kentucky QSO Party
LA-QSO-PARTY|Louisiana QSO Party
RSGB-LOW-POWER|Low Power Field Day
LZ DX|LZ DX Contest
ME-QSO-PARTY|Maine QSO Party
MAR-QSO-PARTY|Maritimes QSO Party
MD-QSO-PARTY|Maryland QSO Party
PSK-DEATHMATCH|MDXA PSK DeathMatch (2005-2010)
XE-INTL-RTTY|Mexico International Contest (RTTY)
MI-QSO-PARTY|Michigan QSO Party
MIDATLANTIC-QSO-PARTY|Mid-Atlantic QSO Party
MN-QSO-PARTY|Minnesota QSO Party
MS-QSO-PARTY|Mississippi QSO Party
MO-QSO-PARTY|Missouri QSO Party
US-COUNTIES-QSO|Mobile Amateur Awards Club
JT-DX-RTTY|Mongolian RTTY DX Contest
MT-QSO-PARTY|Montana QSO Party
EA-DME|Municipios Espanoles
EA-VHF-EA|Nacional VHF
RSGB-NFD|National Field Day
NE-QSO-PARTY|Nebraska QSO Party
NV-QSO-PARTY|Nevada QSO Party
NEQP|New England QSO Party
NH-QSO-PARTY|New Hampshire QSO Party
NJ-QSO-PARTY|New Jersey QSO Party
NM-QSO-PARTY|New Mexico QSO Party
NY-QSO-PARTY|New York QSO Party
NAQP-CW|North America QSO Party (CW)
NAQP-SSB|North America QSO Party (Phone)
NAQP-RTTY|North America QSO Party (RTTY)
NA-SPRINT-CW|North America Sprint (CW)
NA-SPRINT-SSB|North America Sprint (Phone)
NA-SPRINT-RTTY|North America Sprint (RTTY)
NC-QSO-PARTY|North Carolina QSO Party
ND-QSO-PARTY|North Dakota QSO Party
NRAU-BALTIC-CW|NRAU-Baltic Contest (CW)
NRAU-BALTIC-SSB|NRAU-Baltic Contest (SSB)
OCEANIA-DX-CW|Oceania DX Contest (CW)
OCEANIA-DX-SSB|Oceania DX Contest (SSB)
OH-QSO-PARTY|Ohio QSO Party
OK-QSO-PARTY|Oklahoma QSO Party
OMISS-QSO-PARTY|Old Man International Sideband Society QSO Party
ON-QSO-PARTY|Ontario QSO Party
1010-OPEN-SEASON|Open Season Ten Meter QSO Party
UKR-CHAMP-RTTY|Open Ukraine RTTY Championship
OR-QSO-PARTY|Oregon QSO Party
PA-QSO-PARTY|Pennsylvania QSO Party
070-31-FLAVORS|PODXS 31 Flavors
070-40M-SPRINT|PODXS 40m Firecracker Sprint
070-80M-SPRINT|PODXS 80m Jay Hudak Memorial Sprint
070-160M-SPRINT|PODXS Great Pumpkin Sprint
070-PSKFEST|PODXS PSKFest
070-ST-PATS-DAY|PODXS St. Patricks Day
070-3-DAY|PODXS Three Day Weekend
070-VALENTINE-SPRINT|PODXS Valentine Sprint
SP-DX-RTTY|PRC SPDX Contest (RTTY)
EPC-PSK63|PSK63 QSO Party
EA-VHF-QSL|QSL V-UHF & 50MHz
QC-QSO-PARTY|Quebec QSO Party
RAC-CANADA-DAY|RAC Canada Day Contest
RAC-CANADA-WINTER|RAC Canada Winter Contest
VENEZ-IND-DAY|RCV Venezuelan Independence Day Contest
REP-PORTUGAL-DAY-HF|Rede dos Emissores Portugueses Portugal Day HF Contest
REF-160M|Reseau des Emetteurs Francais 160m Contest
REF-CW|Reseau des Emetteurs Francais Contest (CW)
REF-SSB|Reseau des Emetteurs Francais Contest (SSB)
RI-QSO-PARTY|Rhode Island QSO Party
RSGB-ROPOCO|RoPoCo
RDAC|Russian District Award Contest
RDXC|Russian DX Contest
RUSSIAN-RTTY|Russian Radio RTTY Worldwide Contest
EA-VHF-SADURNI|Sant Sadurni V-UHF
SARTG-RTTY|SARTG WW RTTY
SAC-CW|Scandinavian Activity Contest (CW)
SAC-SSB|Scandinavian Activity Contest (SSB)
SCC-RTTY|SCC RTTY Championship
SR-MARATHON|Scottish-Russian Marathon
EA-VHF-EA1RCS|Segovia EA1RCS V-UHF
SC-QSO-PARTY|South Carolina QSO Party
SD-QSO-PARTY|South Dakota QSO Party
SPDXContest|SP DX Contest
SPAR-WINTER-FD|SPAR Winter Field Day(2016 and earlier)
SMP-AUG|SSA Portabeltest
SMP-MAY|SSA Portabeltest
RSGB-SSB-FD|SSB Field Day
STEW-PERRY|Stew Perry Topband Distance Challenge
EA-SMRE-CW|Su Majestad El Rey de Espana - CW
EA-SMRE-SSB|Su Majestad El Rey de Espana - CW
TARA-GRID-DIP|TARA Grid Dip PSK-RTTY Shindig
TARA-RTTY|TARA RTTY Melee
TARA-RUMBLE|TARA Rumble PSK Contest
TARA-SKIRMISH|TARA Skirmish Digital Prefix Contest
10-RTTY|Ten-Meter RTTY Contest
TN-QSO-PARTY|Tennessee QSO Party
TX-QSO-PARTY|Texas QSO Party
TMC-RTTY|The Makrothen Contest
UBA-DX-CW|UBA Contest (CW)
UBA-DX-SSB|UBA Contest (SSB)
UK-DX-RTTY|UK DX RTTY Contest
UKRAINIAN DX|Ukrainian DX
URE-DX|Ukrainian DX Contest
UKSMG-6M-MARATHON|UKSMG 6m Marathon
UKSMG-SUMMER-ES|UKSMG Summer Es Contest
EA-RTTY|Union de Radioaficionados Espanoles RTTY Contest
EA-WW-RTTY|Union de Radioaficionados Espanoles RTTY Contest
UT-QSO-PARTY|Utah QSO Party
VT-QSO-PARTY|Vermont QSO Party
VA-QSO-PARTY|Virginia QSO Party
VIRGINIA QSO PARTY|Virginia QSO Party
DARC-WAEDC-CW|WAE DX Contest (CW)
DARC-WAEDC-RTTY|WAE DX Contest (RTTY)
DARC-WAEDC-SSB|WAE DX Contest (SSB)
WA-QSO-PARTY|Washington QSO Party
WV-QSO-PARTY|West Virginia QSO Party
WIA-HARRY ANGEL|WIA Harry Angel Memorial 80m Sprint
WIA-JMMFD|WIA John Moyle Memorial Field Day
WIA-OCDX|WIA Oceania DX (OCDX) Contest
WIA-REMEMBRANCE|WIA Remembrance Day
WIA-ROSS HULL|WIA Ross Hull Memorial VHF/UHF Contest
WIA-TRANS TASMAN|WIA Trans Tasman Low Bands Challenge
WIA-VHF/UHF FD|WIA VHF UHF Field Days
WIA-VK SHIRES|WIA VK Shires
WFD|Winter Field Day (2017 and later)
WI-QSO-PARTY|Wisconsin QSO Party
WW-DIGI|World Wide Digi DX Contest
WY-QSO-PARTY|Wyoming QSO Party
YOHFDX|YODX HF contest
YUDXC|YU DX Contest